1,0,0,0,0,0,0,0,5,0,0,0,0,0,0,0,0,1
1,0,0,0,0,0,3,0,5,0,0,0,0,0,0,0,9,1
1,2,2,2,2,2,2,2,2,2,2,2,2,2,2,2,2,1
1,0,0,0,0,0,0,0,0,0,0,0,0,0,0,0,0,1
1,0,0,9,0,0,0,3,0,9,0,0,0,0,0,0,0,1
1,2,2,2,2,2,2,2,2,2,2,2,2,2,2,2,2,1