6,0,0,0,0,0,7,0,0,0,0,0,0,0,0,0,0,1
6,0,0,0,0,0,7,0,0,0,0,0,0,0,0,0,0,1
1,2,2,2,2,2,2,2,2,2,2,2,2,2,2,2,2,1
1,0,7,0,0,0,0,0,0,0,0,0,0,0,0,0,0,1
1,0,7,0,0,0,0,0,0,0,0,0,4,0,0,0,0,1
1,2,2,2,2,2,2,2,2,2,2,2,2,2,2,2,2,1